STEPHANIE AND RAYMOND CHESTER JOHNSON,	STEPHANIE CHESTER JOHNSON,	STEPHANIE JOHNSON
HOLLIS GRAHAM AND LAURA ZENAIDA TYLER,	HOLLIS GRAHAM,	HOLLIS GRAHAM TYLER
JAMES TAYLOR AND VICKI ANGELIA WORLEY,	JAMES TAYLOR,	JAMES TAYLOR WORLEY
BRYAN JAY AND JOYCE FAYE GONZALEZ,	BRYAN JAY,	BRYAN JAY GONZALEZ
LOIS BAILEY AND SHAWN FREDDY AYELE,	LOIS BAILEY,	LOIS BAILEY AYELE
JAVIER FRANCIS AND ROXANNA KARINA HERRMANN,	JAVIER FRANCIS,	JAVIER FRANCIS HERRMANN
SUZANNE COREY AND ROYAL BENJAMIN NEAL CAVIN,	SUZANNE COREY NEAL CAVIN,	SUZANNE COREY CAVIN
LEE YAN AND ETHEL JONES,	LEE YAN JONES,	LEE YAN
VELDA BRENDA AND JAMES FOREST FREEMAN SOUTHWELL,	VELDA BRENDA FREEMAN SOUTHWELL,	VELDA BRENDA SOUTHWELL
PROFESSOR JOHN RONALD AND EDNA SUSAN TRAN PAYTON,	PROFESSOR JOHN RONALD TRAN PAYTON,	PROFESSOR JOHN RONALD PAYTON
RYAN HOWARD AND BETTY ROPER,	RYAN HOWARD,	RYAN HOWARD ROPER
TESSIE VANESSA AND EUGENE PAUL HONG,	TESSIE VANESSA PAUL HONG,	TESSIE VANESSA HONG
DONOVAN AND HERMAN WILLIAM PERRY BACANI,	DONOVAN PERRY BACANI,	DONOVAN BACANI
MICHAEL JOSH AND STACY CRUZ HENNESSY,	MICHAEL JOSH CRUZ HENNESSY,	MICHAEL JOSH HENNESSY
REUBEN JEFFERY AND LEOLA DIANA LARA NIMETZ,	REUBEN JEFFERY LARA NIMETZ,	REUBEN JEFFERY NIMETZ
MICHAEL REED AND CONNIE BACA,	MICHAEL REED,	MICHAEL REED BACA
WILLIAM RICHARD AND VERNA ANGELA CHRISTIAN DANIEL,	WILLIAM RICHARD CHRISTIAN DANIEL,	WILLIAM RICHARD DANIEL
TIMOTHY MORRIS AND GERALDINE PATRICK,	TIMOTHY MORRIS,	TIMOTHY MORRIS PATRICK
RAUL JAMES AND BRITTANY OLSON,	RAUL JAMES,	RAUL JAMES OLSON
MARIA THOMAS AND KEVIN MURRAY,	MARIA THOMAS,	MARIA THOMAS MURRAY
LUIS SHELTON AND STEVEN HUGHES,	LUIS SHELTON,	LUIS SHELTON HUGHES
COREY WILLARD AND ANNE INEZ EDGECOMB,	COREY WILLARD,	COREY WILLARD EDGECOMB
GREGORIO GRAHAM AND ELIZABETH PETERSON,	GREGORIO GRAHAM,	GREGORIO GRAHAM PETERSON
ANTONIA HAZEL AND TERESA JOY CRUZ,	ANTONIA HAZEL,	ANTONIA HAZEL CRUZ
JAIME CHASE AND LISE MARY TAYLOR,	JAIME CHASE TAYLOR,	JAIME CHASE